Тест:без ошибок
----- Протокол -----  Дата: 09.09.2020 19:05:24 ----- 
----- Параметры ----- 
-log: in\log.txt
-out: in\out.txt
-in: in\in.txt
----- Исходные данные ----- 
Количество символов: 566
Проигнорировано: 35
Количество строк: 37
Цепочка: print'конер';	не распознана, содержит ошибку. Символ: p, строка: 1, позиция: 1
Цепочка: sc=fs(sa,sb);	не распознана, содержит ошибку. Символ: s, строка: 2, позиция: 1
Цепочка: integer function fi(integer x,integer y)	не распознана, содержит ошибку. Символ: i, строка: 3, позиция: 1
Цепочка: {	не распознана, содержит ошибку. Символ: {, строка: 4, позиция: 1
Цепочка: declare integer z;	не распознана, содержит ошибку. Символ: d, строка: 5, позиция: 1
Цепочка: z=x*(x+y);	не распознана, содержит ошибку. Символ: z, строка: 6, позиция: 1
Цепочка: return z;	не распознана, содержит ошибку. Символ: r, строка: 7, позиция: 1
Цепочка: };	не распознана, содержит ошибку. Символ: }, строка: 8, позиция: 1
Цепочка: string function fs(string a,string b)	не распознана, содержит ошибку. Символ: s, строка: 9, позиция: 1
Цепочка: {	не распознана, содержит ошибку. Символ: {, строка: 10, позиция: 1
Цепочка: declare string c;	не распознана, содержит ошибку. Символ: d, строка: 11, позиция: 1
Цепочка: declare string function substr(string a,integer p,	не распознана, содержит ошибку. Символ: d, строка: 12, позиция: 1
Цепочка: integer n);	не распознана, содержит ошибку. Символ: i, строка: 13, позиция: 1
Цепочка: c=substr(a,1,3)+b;	не распознана, содержит ошибку. Символ: c, строка: 14, позиция: 1
Цепочка: return c;	не распознана, содержит ошибку. Символ: r, строка: 15, позиция: 1
Цепочка: };	не распознана, содержит ошибку. Символ: }, строка: 16, позиция: 1
Цепочка: main	не распознана, содержит ошибку. Символ: m, строка: 17, позиция: 1
Цепочка: {	не распознана, содержит ошибку. Символ: {, строка: 18, позиция: 1
Цепочка: declare integer x;	не распознана, содержит ошибку. Символ: d, строка: 19, позиция: 1
Цепочка: declare integer y;	не распознана, содержит ошибку. Символ: d, строка: 20, позиция: 1
Цепочка: declare integer z;	не распознана, содержит ошибку. Символ: d, строка: 21, позиция: 1
Цепочка: declare string sa;	не распознана, содержит ошибку. Символ: d, строка: 22, позиция: 1
Цепочка: declare string sb;	не распознана, содержит ошибку. Символ: d, строка: 23, позиция: 1
Цепочка: declare string sc;	не распознана, содержит ошибку. Символ: d, строка: 24, позиция: 1
Цепочка: declare integer strlen(string p);	не распознана, содержит ошибку. Символ: d, строка: 25, позиция: 1
Цепочка: x=1;	не распознана, содержит ошибку. Символ: x, строка: 26, позиция: 1
Цепочка: y=5;	не распознана, содержит ошибку. Символ: y, строка: 27, позиция: 1
Цепочка: sa='1234567890';	не распознана, содержит ошибку. Символ: s, строка: 28, позиция: 1
Цепочка: sb='1234567890';	не распознана, содержит ошибку. Символ: s, строка: 29, позиция: 1
Цепочка: z=fi(x,y);	не распознана, содержит ошибку. Символ: z, строка: 30, позиция: 1
Цепочка: sc=fs(sa,sb);	не распознана, содержит ошибку. Символ: s, строка: 31, позиция: 1
Цепочка: print'контрольный пример';	не распознана, содержит ошибку. Символ: p, строка: 32, позиция: 1
Цепочка: print z;	не распознана, содержит ошибку. Символ: p, строка: 33, позиция: 1
Цепочка: print sc;	не распознана, содержит ошибку. Символ: p, строка: 34, позиция: 1
Цепочка: print strlen(sc);	не распознана, содержит ошибку. Символ: p, строка: 35, позиция: 1
Цепочка: return 0;	не распознана, содержит ошибку. Символ: r, строка: 36, позиция: 1
Цепочка: };	не распознана, содержит ошибку. Символ: }, строка: 37, позиция: 1
