integer function fi( integer x, integer y)|{|declare integer z;|z=x*(x+y);|return z;|};|string function fs(string a, string b)|{|declare string c;|declare string function substr(string a, integer p,| integer n);|c= substr(a,1,3)+b;|return c;|};|main|{|declare integer x;|declare integer y;|declare integer z;|declare string sa;|declare string sb;|declare string sc;|declare integer strlen(string p);|x=1;|y=5;|sa='1234567890';|sb='1234567890';|z= fi(x,y);|sc= fs(sa,sb);|print'контрольный пример';|print z;|print sc;|print strlen(sc);|return0;|};


----- Анализ -----  Дата: 24.09.2020 00:09:21 ----- 
Цепочка: integer function fi( integer x, integer y)	не распознана, содержит ошибку. Символ: i, строка: 1, позиция: 1
Цепочка: {	не распознана, содержит ошибку. Символ: {, строка: 2, позиция: 1
Цепочка: declare integer z;	не распознана, содержит ошибку. Символ: d, строка: 3, позиция: 1
Цепочка: z=x*(x+y);	не распознана, содержит ошибку. Символ: z, строка: 4, позиция: 1
Цепочка: return z;	не распознана, содержит ошибку. Символ: r, строка: 5, позиция: 1
Цепочка: };	не распознана, содержит ошибку. Символ: }, строка: 6, позиция: 1
Цепочка: string function fs(string a, string b)	не распознана, содержит ошибку. Символ: s, строка: 7, позиция: 1
Цепочка: {	не распознана, содержит ошибку. Символ: {, строка: 8, позиция: 1
Цепочка: declare string c;	не распознана, содержит ошибку. Символ: d, строка: 9, позиция: 1
Цепочка: declare string function substr(string a, integer p,	не распознана, содержит ошибку. Символ: d, строка: 10, позиция: 1
Цепочка:  integer n);	не распознана, содержит ошибку. Символ:  , строка: 11, позиция: 1
Цепочка: c= substr(a,1,3)+b;	не распознана, содержит ошибку. Символ: c, строка: 12, позиция: 1
Цепочка: return c;	не распознана, содержит ошибку. Символ: r, строка: 13, позиция: 1
Цепочка: };	не распознана, содержит ошибку. Символ: }, строка: 14, позиция: 1
Цепочка: main	не распознана, содержит ошибку. Символ: m, строка: 15, позиция: 1
Цепочка: {	не распознана, содержит ошибку. Символ: {, строка: 16, позиция: 1
Цепочка: declare integer x;	не распознана, содержит ошибку. Символ: d, строка: 17, позиция: 1
Цепочка: declare integer y;	не распознана, содержит ошибку. Символ: d, строка: 18, позиция: 1
Цепочка: declare integer z;	не распознана, содержит ошибку. Символ: d, строка: 19, позиция: 1
Цепочка: declare string sa;	не распознана, содержит ошибку. Символ: d, строка: 20, позиция: 1
Цепочка: declare string sb;	не распознана, содержит ошибку. Символ: d, строка: 21, позиция: 1
Цепочка: declare string sc;	не распознана, содержит ошибку. Символ: d, строка: 22, позиция: 1
Цепочка: declare integer strlen(string p);	не распознана, содержит ошибку. Символ: d, строка: 23, позиция: 1
Цепочка: x=1;	не распознана, содержит ошибку. Символ: x, строка: 24, позиция: 1
Цепочка: y=5;	не распознана, содержит ошибку. Символ: y, строка: 25, позиция: 1
Цепочка: sa='1234567890';	не распознана, содержит ошибку. Символ: s, строка: 26, позиция: 1
Цепочка: sb='1234567890';	не распознана, содержит ошибку. Символ: s, строка: 27, позиция: 1
Цепочка: z= fi(x,y);	не распознана, содержит ошибку. Символ: z, строка: 28, позиция: 1
Цепочка: sc= fs(sa,sb);	не распознана, содержит ошибку. Символ: s, строка: 29, позиция: 1
Цепочка: print'контрольный пример';	не распознана, содержит ошибку. Символ: p, строка: 30, позиция: 1
Цепочка: print z;	не распознана, содержит ошибку. Символ: p, строка: 31, позиция: 1
Цепочка: print sc;	не распознана, содержит ошибку. Символ: p, строка: 32, позиция: 1
Цепочка: print strlen(sc);	не распознана, содержит ошибку. Символ: p, строка: 33, позиция: 1
Цепочка: return0;	не распознана, содержит ошибку. Символ: r, строка: 34, позиция: 1
